Sample_name_1	AACTGTGC	AACTGTGG
Sample_name_2	TCGTACAG	TCGTACAG
Sample_name_3	CTCACTGC	CTCACTGG
Sample_name_4	GTGCTACT	GTGCTACT
Sample_name_5	GCTTGACC	GCTTGACG
Sample_name_6	CATCATCT	CATCATCT
Sample_name_7	TGCTACTC	TGCTACTG
Sample_name_8	AGAAGTGT	AGAAGTGT
Sample_name_9	AACTGTGC	TCGTACAG
Sample_name_10	TCGTACAG	CTCACTGG
Sample_name_11	CTCACTGC	GTGCTACT
Sample_name_12	GTGCTACT	GCTTGACG
Sample_name_13	GCTTGACC	CATCATCT
Sample_name_14	CATCATCT	TGCTACTG
Sample_name_15	TGCTACTC	AGAAGTGT
Sample_name_16	AGAAGTGT	AACTGTGG
Sample_name_17	AACTGTGC	CTCACTGG
Sample_name_18	TCGTACAG	GTGCTACT
Sample_name_19	CTCACTGC	GCTTGACG
Sample_name_20	GTGCTACT	CATCATCT
Sample_name_21	GCTTGACC	TGCTACTG
Sample_name_22	CATCATCT	AGAAGTGT
Sample_name_23	TGCTACTC	AACTGTGG
Sample_name_24	AGAAGTGT	TCGTACAG
Sample_name_25	AACTGTGC	GTGCTACT
Sample_name_26	TCGTACAG	GCTTGACG
Sample_name_27	CTCACTGC	CATCATCT
Sample_name_28	GTGCTACT	TGCTACTG
Sample_name_29	GCTTGACC	AGAAGTGT
Sample_name_30	CATCATCT	AACTGTGG
Sample_name_31	TGCTACTC	TCGTACAG
Sample_name_32	AGAAGTGT	CTCACTGG
Sample_name_33	AACTGTGC	GCTTGACG
Sample_name_34	TCGTACAG	CATCATCT
Sample_name_35	CTCACTGC	TGCTACTG
Sample_name_36	GTGCTACT	AGAAGTGT
Sample_name_37	GCTTGACC	AACTGTGG
Sample_name_38	CATCATCT	TCGTACAG
Sample_name_39	TGCTACTC	CTCACTGG
Sample_name_40	AGAAGTGT	GTGCTACT
Sample_name_41	AACTGTGC	CATCATCT
Sample_name_42	TCGTACAG	TGCTACTG
Sample_name_43	CTCACTGC	AGAAGTGT
Sample_name_44	GTGCTACT	AACTGTGG
Sample_name_45	GCTTGACC	TCGTACAG
Sample_name_46	CATCATCT	CTCACTGG
Sample_name_47	TGCTACTC	GTGCTACT
Sample_name_48	AGAAGTGT	GCTTGACG
Sample_name_49	AACTGTGC	TGCTACTG
Sample_name_50	TCGTACAG	AGAAGTGT
Sample_name_51	CTCACTGC	AACTGTGG
Sample_name_52	GTGCTACT	TCGTACAG
Sample_name_53	GCTTGACC	CTCACTGG
Sample_name_54	CATCATCT	GTGCTACT
Sample_name_55	TGCTACTC	GCTTGACG
Sample_name_56	AGAAGTGT	CATCATCT
Sample_name_57	AACTGTGC	AGAAGTGT
Sample_name_58	TCGTACAG	AACTGTGG
Sample_name_59	CTCACTGC	TCGTACAG
Sample_name_60	GTGCTACT	CTCACTGG
Sample_name_61	GCTTGACC	GTGCTACT
Sample_name_62	CATCATCT	GCTTGACG
Sample_name_63	TGCTACTC	CATCATCT
Sample_name_64	AGAAGTGT	TGCTACTG
Sample_name_65	AACTGTGC	AGTGTCAG
Sample_name_66	TCGTACAG	TCACAGGT
Sample_name_67	CTCACTGC	CCTTAGAG
Sample_name_68	GTGCTACT	GTAAGGTC
Sample_name_69	GCTTGACC	GATCGAGG
Sample_name_70	CATCATCT	CAAGAGAC
Sample_name_71	TGCTACTC	TAGAAGAG
Sample_name_72	AGAAGTGT	AGCGTGTA
Sample_name_73	AACTGTGC	TCACAGGT
Sample_name_74	TCGTACAG	CCTTAGAG
Sample_name_75	CTCACTGC	GTAAGGTC
Sample_name_76	GTGCTACT	GATCGAGG
Sample_name_77	GCTTGACC	CAAGAGAC
Sample_name_78	CATCATCT	TAGAAGAG
Sample_name_79	TGCTACTC	AGCGTGTA
Sample_name_80	AGAAGTGT	AGTGTCAG
Sample_name_81	AACTGTGC	CCTTAGAG
Sample_name_82	TCGTACAG	GTAAGGTC
Sample_name_83	CTCACTGC	GATCGAGG
Sample_name_84	GTGCTACT	CAAGAGAC
Sample_name_85	GCTTGACC	TAGAAGAG
Sample_name_86	CATCATCT	AGCGTGTA
Sample_name_87	TGCTACTC	AGTGTCAG
Sample_name_88	AGAAGTGT	TCACAGGT
Sample_name_89	AACTGTGC	GTAAGGTC
Sample_name_90	TCGTACAG	GATCGAGG
Sample_name_91	CTCACTGC	CAAGAGAC
Sample_name_92	GTGCTACT	TAGAAGAG
Sample_name_93	GCTTGACC	AGCGTGTA
Sample_name_94	CATCATCT	AGTGTCAG
Sample_name_95	TGCTACTC	TCACAGGT
Sample_name_96	AGAAGTGT	CCTTAGAG